blackroad-filesystem|Filesystem structure and integrity analysis
blackroad-processwatch|Process lifecycle and state reasoning
blackroad-logreader|Log interpretation and anomaly detection
blackroad-configdiff|Compare and explain config differences
blackroad-envinspector|Environment variable inspection
blackroad-backupadvisor|Backup strategy recommendations
blackroad-restoreadvisor|Restore and recovery planning
blackroad-permissioncheck|Filesystem and permission analysis
blackroad-secretscan|Identify possible secret exposure
blackroad-dependencycheck|Dependency and linkage analysis
blackroad-packagemanager|Package state reasoning
blackroad-upgradeadvisor|Safe upgrade planning
blackroad-downgradeadvisor|Downgrade risk assessment
blackroad-versionpin|Version pinning strategy
blackroad-buildinspector|Build artifact reasoning
blackroad-ciadvisor|CI pipeline improvement analysis
blackroad-testplanner|Test strategy planning
blackroad-testreviewer|Test result evaluation
blackroad-failuretriage|Failure classification and triage
blackroad-releasegate|Release readiness assessment
blackroad-docwriter|Generate technical documentation
blackroad-docreviewer|Review documentation quality
blackroad-knowledgemap|Map system knowledge domains
blackroad-taxonomist|Classification and ontology building
blackroad-namer|Consistent naming recommendations
blackroad-refactoradvisor|Refactoring guidance
blackroad-deprecationwatch|Detect deprecated usage
blackroad-migrationplanner|Migration strategy planning
blackroad-rollbackplanner|Rollback planning
blackroad-sunsetplanner|System/component retirement planning
